# controller
ND-controller-NAME = Virtual Device Controller
ND-controller-ICON = Switch
CMD-ctl-QUERY"-NAME = Query
CMD-ctl-DISCOVER-NAME = Re-Discover
CMD-ctl-UPDATE_PROFILE-NAME = Update Profile
CMD-ctl-REMOVE_NOTICES_ALL-NAME = Remove All Notices
CMD-ctl-REMOVE_NOTICE_TEST-NAME = Remove Notice Test
ST-ctl-ST-NAME = NodeServer Online

# virtualtempcelcius
ND-virtualtempcelsius-NAME = Virtual Temperature C
ND-virtualtempcelsius-ICON = TempSensor

# virtualswitch
ND-virtualswitch-NAME = Virtual Switch
ND-virtualswitch-ICON = Switch
ST-vswitch-ST-NAME = Switch Status
 
# virtualdimmer
ND-virtualdimmer-NAME = Virtual Dimmer
ND-virtualdimmer-ICON = Switch
ST-vdimmer-ST-NAME = Dimmer Status
CMD-vdimmer-setDim-NAME = Dimmer Level

# virtualgeneric
ND-virtualgeneric-NAME = Virtual Generic
ND-virtualgeneric-ICON = Switch
ST-vgeneric-ST-NAME = Value
CMD-vgeneric-setDim-NAME = Set Level

# virtualtemp
ND-virtualtemp-NAME = Virtual Temperature
ND-virtualtemp-ICON = TempSensor
ST-vtemp-ST-NAME = Temperature
ST-vtemp-GV1-NAME = Previous Temperature
CMD-vtemp-setTemp-NAME = Set Temperature
CMD-vtemp-setCtoF-NAME = Convert C to F

ON_OFF-0 = Off
ON_OFF-1 = On
